####F##
#.##..#
#.###.#
#.S##.#
#...#.#
#.#...#  
#######