#F...###
###...##
#.#.#..#
#...##.#
#####..# 
#S##..##
#....###
###.####