##########
#.##.....#
#..#.#.#.#
#........#
##.#.###.#
##.#.#...#
#....##..F
#.##...#.#
#S..###.##
##########
